Amnesia
An Interactive Fiction by Ben Helm
Release 1 / Serial number 140313 / Inform 7 build 6G60 (I6/v6.32 lib 6/12N) SD

roof
You wake up lying on your back on the roof of a building.  There are no visible doors but there is a fire escape down from you.

You stand up, dizzy, trying to remember any events that might have transpired leaving you in this dire predicament.  Nothing comes to mind.

A crumpled scrap of paper lies on the ground.

>go north
You can't go that way.

>eat my butt
I only understood you as far as wanting to eat yourself.

>eat your butt
You can't see any such thing.

>slap my face
That's not a verb I recognise.

>take my face
You can't see any such thing.

>swing my face
You can't see any such thing.

>at your face
That's not a verb I recognise.

>kill myself
Violence isn't the answer to this one.

>kill yourself
Violence isn't the answer to this one.

>kill the dog
You can't see any such thing.

>eat the dog
You can't see any such thing.

>eat my mouth
I only understood you as far as wanting to eat yourself.

>eat my
(yourself)
(first taking yourself)
You are always self-possessed.

>say butt
(to yourself)
There is no reply.

>say fatty fat fatty
(to yourself)
There is no reply.

>yell
That's not a verb I recognise.

>jump
You jump on the spot, fruitlessly.

>jump down
I only understood you as far as wanting to jump.

>jump on my face
I only understood you as far as wanting to jump.

* * *

Amnesia
An Interactive Fiction by Ben Helm
Release 1 / Serial number 140313 / Inform 7 build 6G60 (I6/v6.32 lib 6/12N) SD

roof
You wake up lying on your back on the roof of a building.  There are no visible doors but there is a fire escape down from you.

You stand up, dizzy, trying to remember any events that might have transpired leaving you in this dire predicament.  Nothing comes to mind.

A crumpled scrap of paper lies on the ground.

>take coin
Taken.

>examine coin
You see nothing special about the Rusty Coin.

>drop coin
Dropped.

>take coin
Taken.

>examine it
You see nothing special about the Rusty Coin.

>drop it
Dropped.

>take it
Taken.

>drop it
Dropped.

>examine it
You see nothing special about the Rusty Coin.

* * *

>take coin
Taken.

>drop coin
Dropped.

>pee on it
That's not a verb I recognise.

>pee on my head
That's not a verb I recognise.

>take my face
You can't see any such thing.

>take my butt
You can't see any such thing.

>eat my face
You can't see any such thing.

>eat my butt
You can't see any such thing.

>drop your pants
You can't see any such thing.

* * *

Amnesia
An Interactive Fiction by Ben Helm
Release 1 / Serial number 140313 / Inform 7 build 6G60 (I6/v6.32 lib 6/12N) SD

roof
You wake up lying on your back on the roof of a building.  There are no visible doors but there is a fire escape down from you.

You stand up, dizzy, trying to remember any events that might have transpired leaving you in this dire predicament.  Nothing comes to mind.

A crumpled scrap of paper lies on the ground.

>take scrap
Taken.

>drop it
Dropped.

>take paper
Taken.

>drop it
Dropped.

>take of
Taken.

>drop it
Dropped.

>examine it
On the paper is scrawled in red script the word  BUTTSACK .

* * *

Amnesia
An Interactive Fiction by Ben Helm
Release 1 / Serial number 140313 / Inform 7 build 6G60 (I6/v6.32 lib 6/12N) SD

roof
You wake up lying on your back on the roof of a building.  There are no visible doors but there is a fire escape down from you.

You stand up, dizzy, trying to remember any events that might have transpired leaving you in this dire predicament.  Nothing comes to mind.

A crumpled scrap of paper lies on the ground.

>take bottle
Which do you mean, the white bottle or the black bottle?

>take white bottle
Taken.

>drop it
Dropped.

>take white
Taken.

>drop it
Dropped.

>examine white
Inside the bottle is a liquid that appears to be water.

>drink liquid
You can't see any such thing.

* * *

Amnesia
An Interactive Fiction by Ben Helm
Release 1 / Serial number 140313 / Inform 7 build 6G60 (I6/v6.32 lib 6/12N) SD

roof
You wake up lying on your back on the roof of a building.  There are no visible doors but there is a fire escape down from you.

You stand up, dizzy, trying to remember any events that might have transpired leaving you in this dire predicament.  Nothing comes to mind.

A crumpled scrap of paper lies on the ground.

>take paper
[Your score has just gone up by ten points.]

>examine paper
On the paper is scrawled in red script are the words  not again

>go down
fire escape
You hang from the edge of the building and drop down 10 feet onto the fire escape, landing precariously and barely keeping your balance above a dizzying drop.   A rickety set of metal stairs leads down to the ground.

Lying next to your foot is a bottle with a single pill in it.

>go up
roof
You stand as a solitary figure on the empty rooftop.  The fire escape is below you.

>go down
fire escape
You stand somewhat uncomfortably on the fire escape with the rickety stairs below you and the roof a short but frightening climb above you.

Lying next to your foot is a bottle with a single pill in it.

>take bottle
Taken.

>examine pill
In bright letters it says "Radiation Medication."  There appears to be some fine print below it.

>eat it
Your head starts to spin and you fall to your knees, vomiting uncontrollably through the grate of the fire escape for several minutes
[Your score has just gone up by ten points.]

>go down
alley
After an arduous descent down the rusting stairs, you find yourself in a dimly lit alley.  To the west you can see the street.  East the alley appears to go deeper, and gets darker as it goes.

Nearby you lurks a mangy looking alley cat.  Perhaps it is safe to take with you as a companion.

>examine cat
It is clearly very diseased, and is looking at you as if you were a meal.

>go east
deep alley
It is darker here.  Your eyes adjust slowly.

You can see the outline of a woman standing nearby.

>examine woman
You can't see any such thing.

>examine vagabond
What did your parents tell you about talking to strangers?  Then again... she might know what happened.

>ask woman what happened
You can't see any such thing.

>ask vagabond what happened.
I didn't understand that sentence.

>ask vagabond what happened
I didn't understand that sentence.

* * *

>take paper
[Your score has just gone up by ten points.]

>go down
fire escape
You hang from the edge of the building and drop down 10 feet onto the fire escape, landing precariously and barely keeping your balance above a dizzying drop.   A rickety set of metal stairs leads down to the ground.

Lying next to your foot is a bottle with a single pill in it.

>go down
alley
After an arduous descent down the rusting stairs, you find yourself in a dimly lit alley.  To the west you can see the street.  East the alley appears to go deeper, and gets darker as it goes.

Nearby you lurks a mangy looking alley cat.  Perhaps it is safe to take with you as a companion.

>take cat
The rabid beast leaps onto your face and claws you until you collapse into an unconscious heap to be devoured.

    *** You died bravely in the process being food for a rabid alley cat. ***

In that game you scored 0 out of a possible 0, in 4 turns.

Would you like to RESTART, RESTORE a saved game, QUIT or UNDO the last command?

* * *

>go down
fire escape
You hang from the edge of the building and drop down 10 feet onto the fire escape, landing precariously and barely keeping your balance above a dizzying drop.   A rickety set of metal stairs leads down to the ground.

Lying next to your foot is a bottle with a single pill in it.

>go up
roof

* * *

Amnesia
An Interactive Fiction by Ben Helm
Release 1 / Serial number 140313 / Inform 7 build 6G60 (I6/v6.32 lib 6/12N) SD

roof
You wake up lying on your back on the roof of a building.  There are no visible doors but there is a fire escape down from you.

You stand up, dizzy, trying to remember any events that might have transpired leaving you in this dire predicament.  Nothing comes to mind.

A crumpled scrap of paper lies on the ground.

>take all
scrap of paper: Taken.
rope: Taken.

>examine rope
It appears to be relatively new, and might be long enough to reach the ground.

>examine paper
On the paper is scrawled in red script are the words  save me .

>look down
You see nothing unexpected in that direction.

>go down
street
After an arduous descent down hundreds of feet of solid granite, you find yourself at the side of an empty street.

Directly in front of you is an ornate revolving door, an entrance to the building.

>examine door
The lock seems to have been forcibly broken, and the door swings freely.

>take door
Taken.

>inventory
You are carrying:
  a revolving door
  a rope
  a scrap of paper

* * *

Amnesia
An Interactive Fiction by Ben Helm
Release 1 / Serial number 140313 / Inform 7 build 6G60 (I6/v6.32 lib 6/12N) SD

roof
You wake up lying on your back on the roof of a building.  There are no visible doors but there is a fire escape down from you.

You stand up, dizzy, trying to remember any events that might have transpired leaving you in this dire predicament.  Nothing comes to mind.

A crumpled scrap of paper lies on the ground.

>go down
fire escape
You hang from the edge of the building and drop down 10 feet onto the fire escape, landing precariously and barely keeping your balance above a dizzying drop.   A rickety set of metal stairs leads down to the ground.

Lying next to your foot is a bottle with a single pill in it.

>look
street
After an arduous descent down hundreds of feet of solid granite, you find yourself at the side of an empty street.

>examine door
Directly in front of you is an ornate revolving door, an entrance to the building. The lock seems to have been forcibly broken, and the door swings freely.

* * *

>go down
fire escape
You hang from the edge of the building and drop down 10 feet onto the fire escape, landing precariously and barely keeping your balance above a dizzying drop.   A rickety set of metal stairs leads down to the ground.

Lying next to your foot is a bottle with a single pill in it.

>enter door
(first opening the revolving door)

lobby
You can see a revolving door here.

* * *

>go down
fire escape
You hang from the edge of the building and drop down 10 feet onto the fire escape, landing precariously and barely keeping your balance above a dizzying drop.   A rickety set of metal stairs leads down to the ground.

Lying next to your foot is a bottle with a single pill in it.

>open door
You open the revolving door.

>go through door
lobby
Directly in front of you is an ornate revolving door.  It appears to be an entrance to the building.

* * *

>go down
fire escape
You hang from the edge of the building and drop down 10 feet onto the fire escape, landing precariously and barely keeping your balance above a dizzying drop.   A rickety set of metal stairs leads down to the ground.

Lying next to your foot is a bottle with a single pill in it.

>ask Bradley about the building
Bradley says: "What do you mean?  That is where we used to work!

>ask Bradly about building
You can't see any such thing.

* * *

>ask Bradley about the building
Bradley says: "What do you mean?  That is where we used to work!

>examine Bradley
You see nothing special about Bradley.

>examine man
You can't see any such thing.

* * *

>go down
fire escape
You hang from the edge of the building and drop down 10 feet onto the fire escape, landing precariously and barely keeping your balance above a dizzying drop.   A rickety set of metal stairs leads down to the ground.

Lying next to your foot is a bottle with a single pill in it.

>ask him about the building
Bradley in an incredulous tone says: "What do you mean?  That is where we used to work!

* * *

>go down
fire escape
You hang from the edge of the building and drop down 10 feet onto the fire escape, landing precariously and barely keeping your balance above a dizzying drop.   A rickety set of metal stairs leads down to the ground.

Lying next to your foot is a bottle with a single pill in it.

>take all
There are none at all available!

* * *

>go down
alley
After an arduous descent down the rusting stairs, you find yourself in a dimly lit alley.  To the west you can see the street.  East the alley appears to go deeper, and gets darker as it goes.

Nearby you lurks a mangy looking alley cat.  Perhaps it is safe to take with you as a companion.

>take cat
The rabid beast leaps onto your face and claws you until you collapse into an unconscious heap to be devoured.

    *** You died bravely in the process being food for a rabid alley cat. ***

In that game you scored 0 out of a possible 0, in 3 turns.

Would you like to RESTART, RESTORE a saved game, QUIT or UNDO the last command?

>examine cat
It is clearly very diseased.

>take cat
I don't suppose the cat would care for that.

* * *

>take cat
The rabid beast leaps onto your face and claws you until you collapse into an unconscious heap to be devoured.

    *** You died bravely in the process being food for a rabid alley cat. ***

In that game you scored 0 out of a possible 0, in 3 turns.

Would you like to RESTART, RESTORE a saved game, QUIT or UNDO the last command?

>undo
alley
[Previous turn undone.]

>look
alley
After an arduous descent down the rusting stairs, you find yourself in a dimly lit alley.  To the west you can see the street.  East the alley appears to go deeper, and gets darker as it goes.

Nearby you lurks a mangy looking alley cat.

* * *

>undo
alley
[Previous turn undone.]

>go west
street
Blinking in the bright sun you find yourself standing in the middle of a busy street.  People hurry by each other without making eye contact.  To the south is the sidewalk at the other side of the street.  Directly in front of you is an ornate revolving door.

Next to the door is a man leaning against the wall wearing a tuxedo.  He is tall and lean, and is smoking a cigarette.

>go through door
(first opening the revolving door)

lobby
You are standing in the center of the lobby of a modern looking building.  In addition to the revolving door, there is a glass door that appears to lead outside to the west and a metal door to the north.  In the center of the room is a fountain, and around the rim is a sign in tarnished bronze lettering.

>examine fountain
It is completely dry, and appears to have been that way for some time.

>examine sign
It reads National Artificial Intelligence Agency

[Your score has just gone up by ten points.]

>go through metal door
(first opening the metal door)

operating room
You are in what appears to be an OR, with an operating table on the center and various machines around it. To the east is an entryway to a room with an ominous orange glow coming from it.  There is a gigantic hydraulic injection needle next to the table, with a computer attached to it.

Lying on the floor is a crumpled piece of paper with the phrase "Lab Notes" written at the top.

>take computer
That's hardly portable.

>examine computer
On the screen is green writing on a black background that says "Test subject 0".  Below it is a picture of your face.

[Your score has just gone up by ten points.]

>examine entryway
You can't see any such thing.

>examine lab notes
It says

"Subject experiences massive memory loss and erratic behavior. Subject's radiation levels far exceed normal limits, yet no damage to the brain can be seen".

[Your score has just gone up by ten points.]

>examine needle
You see nothing special about the needle.

>look
operating room
You are in what appears to be an OR, with an operating table on the center and various machines around it. To the east is an entryway to a room with an ominous orange glow coming from it.  There is a gigantic hydraulic injection needle next to the table, with a computer attached to it.

Lying on the floor is a crumpled piece of paper with the phrase "Lab Notes" written at the top.

>go east
furnace room
In one wall of the room is a gigantic incinerator, big enough for a truck to pass through.

Standing next to the incinerator is a woman wearing a HAZMAT suit.

>examine woman
She looks to be a scientist.  Maybe she knows you.

>ask woman about me
The woman turns around and her eyes go wide when she sees you.  In a solemn voice she says "So you are back.  I didn't know how long you would be gone this time.  Each time you are gone for longer, and you infect more people.  This time was almost three months.  In the year since you were injected with the learning chip you have infected nearly 3 million people, but every time you return back here you can't remember it.  There is no way to stop you.  Unless...."  She slowly looks towards the incinerator.

>go through incinerator
(first opening the incinerator)

heaven
You stand among the clouds in front of a massive golden gate.

>go through gate
(first opening the gate)
You sacrificed yourself to save humankind, proving that perhaps you weren't the monster that you thought....

    *** You have won ***

In that game you scored 30 out of a possible 0, in 17 turns.

Would you like to RESTART, RESTORE a saved game, QUIT or UNDO the last command?

* * *

>go down
alley
After an arduous descent down the rusting stairs, you find yourself in a dimly lit alley.  To the west you can see the street.  East the alley appears to go deeper, and gets darker as it goes.

Nearby you lurks a mangy looking alley cat.  Perhaps it is safe to take with you as a companion.

>take rope
Taken.

>go down
You jump down to the fire escape but it was much farther than you anticipated, and your legs both break on impact.  Your vision darkens and you fall unconscious

* * *

>go down
alley
After an arduous descent down the rusting stairs, you find yourself in a dimly lit alley.  To the west you can see the street.  East the alley appears to go deeper, and gets darker as it goes.

Nearby you lurks a mangy looking alley cat.  Perhaps it is safe to take with you as a companion.

>examine cat
It is clearly very diseased.

* * *

>go down
alley
After an arduous descent down the rusting stairs, you find yourself in a dimly lit alley.  To the west you can see the street.  East the alley appears to go deeper, and gets darker as it goes.

Nearby you lurks a mangy looking alley cat.  Perhaps it is safe to take with you as a companion.

>go east
deep alley
It is darker here.  Your eyes adjust slowly.

You can see the outline of a woman standing nearby.

>say hi
(to Vagabond)
There is no reply.

* * *

>go east
deep alley
It is darker here.  Your eyes adjust slowly.

You can see the outline of a woman standing nearby.

>say no
(to Vagabond)
There is no reply.

>say hi
(to Vagabond)
There is no reply.

>say
I didn't understand that sentence.

* * *

>go east
deep alley
It is darker here.  Your eyes adjust slowly.

You can see the outline of a woman standing nearby.

>examine woman
What did your parents tell you about talking to strangers?  Then again... she might know what happened.

>go west
alley
After an arduous descent down the rusting stairs, you find yourself in a dimly lit alley.  To the west you can see the street.  East the alley appears to go deeper, and gets darker as it goes.

Nearby you lurks a mangy looking alley cat.  Perhaps it is safe to take with you as a companion.

>go west
street
Blinking in the bright sun you find yourself standing in the middle of a busy street.  People hurry by each other without making eye contact.

Directly in front of you is an ornate revolving door.  It appears to be an entrance to the building.  There is caution tape blocking it off.

Next to the door is a man leaning against the wall wearing a tuxedo.  He is tall and lean, and is smoking a cigarette.

>examine man
You can't see any such thing.

>look
street
Blinking in the bright sun you find yourself standing in the middle of a busy street.  People hurry by each other without making eye contact.

Directly in front of you is an ornate revolving door.  It appears to be an entrance to the building.  There is caution tape blocking it off.

Next to the door is a man leaning against the wall wearing a tuxedo.  He is tall and lean, and is smoking a cigarette.

* * *

>examine woman
What did your parents tell you about talking to strangers?  Then again... she might know what happened.

>ask vagabond what happened
I didn't understand that sentence.

>ask vagabond about what happened
The woman's eyes go wide and she says "You mean the overtaking? How could you not know?

* * *

>go east
deep alley
It is darker here.  Your eyes adjust slowly.

You can see the outline of a woman standing nearby.

>go west
alley
You stand in the dim alley, with the street to the west and the alley extending to the east.

Nearby you lurks a mangy looking alley cat.  Perhaps it is safe to take with you as a companion.

>examine cat
It is clearly very diseased, and is looking at you as if you were a meal.

>take cat
The rabid beast leaps onto your face and claws you until you collapse into an unconscious heap to be devoured.

    *** You died bravely in the process being food for a rabid alley cat. ***

In that game you scored 0 out of a possible 0, in 6 turns.

Would you like to RESTART, RESTORE a saved game, QUIT or UNDO the last command?

* * *

>go down
alley
After an arduous descent down the rusting stairs, you find yourself in a dimly lit alley.  To the west you can see the street.  East the alley appears to go deeper, and gets darker as it goes.

Nearby you lurks a mangy looking alley cat.  Perhaps it is safe to take with you as a companion.

>go down
You can't go that way.

>go west
street
Blinking in the bright sun you find yourself standing in the middle of a busy street.  People hurry by each other without making eye contact.

Directly in front of you is an ornate revolving door.  It appears to be an entrance to the building.  There is caution tape blocking it off.

Next to the door is a man leaning against the wall wearing a tuxedo.  He is tall and lean, and is smoking a cigarette.

>examine man
Sticking out of his pocket is a flask with the name  Bradley  engraved on it.  He appears to be someone who might know about the building.

>ask man about building
There is no reply.

>ask bradley about building
There is no reply.

* * *

>go west
street
Blinking in the bright sun you find yourself standing in the middle of a busy street.  People hurry by each other without making eye contact.

Directly in front of you is an ornate revolving door.  It appears to be an entrance to the building.  There is caution tape blocking it off.

Next to the door is a man leaning against the wall wearing a tuxedo.  He is tall and lean, and is smoking a cigarette.

>ask bradley about the building
He says in an incredulous tone: "What do you mean?!?  That is where we used to work!

[Your score has just gone up by ten points.]

>go down
You can't go that way.

>examine man
Sticking out of his pocket is a flask with the name  Bradley  engraved on it.  He appears to be someone who might know about the building.

[Your score has just gone up by ten points.]

* * *

>go down
alley
After an arduous descent down the rusting stairs, you find yourself in a dimly lit alley.  To the west you can see the street.  East the alley appears to go deeper, and gets darker as it goes.

Nearby you lurks a mangy looking alley cat.  Perhaps it is safe to take with you as a companion.

>go west
street
Blinking in the bright sun you find yourself standing in the middle of a busy street.  People hurry by each other without making eye contact.  To the south is the sidewalk at the other side of the street.  Directly in front of you is an ornate revolving door.

Next to the door is a man leaning against the wall wearing a tuxedo.  He is tall and lean, and is smoking a cigarette.

>ask man about building
He says in an incredulous tone: "What do you mean?!?  That is where we used to work!

* * *

>go west
street
Blinking in the bright sun you find yourself standing in the middle of a busy street.  People hurry by each other without making eye contact.  To the south is the sidewalk at the other side of the street.  Directly in front of you is an ornate revolving door.

Next to the door is a man leaning against the wall wearing a tuxedo.  He is tall and lean, and is smoking a cigarette.

>examine man
Sticking out of his pocket is a flask with the name  Bradley  engraved on it.  He appears to be someone who might know about the building.

[Your score has just gone up by ten points.]

>ask man about building
He says in an incredulous tone: "What do you mean?!?  That is where we used to work!

[Your score has just gone up by ten points.]

>ask man about the building
There is no reply.

>go down
You can't go that way.

* * *

>go west
street
Blinking in the bright sun you find yourself standing in the middle of a busy street.  People hurry by each other without making eye contact.  To the south is the sidewalk at the other side of the street.  Directly in front of you is an ornate revolving door.

Next to the door is a man leaning against the wall wearing a tuxedo.  He is tall and lean, and is smoking a cigarette.

>open door
You open the revolving door.

>enter door
lobby
You are standing in the center of the lobby of a modern looking building.

Directly in front of you is an ornate revolving door.  It appears to be an entrance to the building.  There is caution tape blocking it off.

* * *

>go west
street
Blinking in the bright sun you find yourself standing in the middle of a busy street.  People hurry by each other without making eye contact.  To the south is the sidewalk at the other side of the street.  Directly in front of you is an ornate revolving door.

Next to the door is a man leaning against the wall wearing a tuxedo.  He is tall and lean, and is smoking a cigarette.

>examine door
There is caution tape blocking it off, but you can remove it easily.  The lock seems to have been forcibly broken recently.

>go through door
(first opening the revolving door)

lobby
You are standing in the center of the lobby of a modern looking building.

* * *

>go west
street
Blinking in the bright sun you find yourself standing in the middle of a busy street.  People hurry by each other without making eye contact.  To the south is the sidewalk at the other side of the street.  Directly in front of you is an ornate revolving door.

Next to the door is a man leaning against the wall wearing a tuxedo.  He is tall and lean, and is smoking a cigarette.

>go through door
(first opening the revolving door)

lobby
You are standing in the center of the lobby of a modern looking building.  In addition to the revolving door, there is a glass door that appears to lead outside.

In the center of the room is a fountain.

Around the rim of the fountain is a sign in tarnished bronze lettering.

>examine fountain
It is completely dry, and appears to have been that way for some time.

>examine sign
It reads National Artificial Intelligence Agency

* * *

>go through door
(first opening the revolving door)

lobby
You are standing in the center of the lobby of a modern looking building.  In addition to the revolving door, there is a glass door that appears to lead outside.

In the center of the room is a fountain.

Around the rim of the fountain is a sign in tarnished bronze lettering.

>go west
courtyard
You stand in a beautiful courtyard.

Lying on a bench is a newspaper, with a picture of the lobby on the front page.

>examine newspaper
The headline reads "NAIA Introduces Revolutionary New Learning Chip Brain Implant.

* * *

>go through door
(first opening the revolving door)

lobby
You are standing in the center of the lobby of a modern looking building.  In addition to the revolving door, there is a glass door that appears to lead outside.

In the center of the room is a fountain.

Around the rim of the fountain is a sign in tarnished bronze lettering.

>go through door
(the glass door)
(first opening the glass door)

courtyard
You stand in a beautiful courtyard.

Lying on a bench is a newspaper, with a picture of the lobby on the front page.

You can also see the glass door here.

* * *

>go through door
(first opening the revolving door)

lobby
You are standing in the center of the lobby of a modern looking building.  In addition to the revolving door, there is a glass door that appears to lead outside.

In the center of the room is a fountain.

Around the rim of the fountain is a sign in tarnished bronze lettering.

>go north
(first opening the metal door)

operating room
You are in what appears to be an OR, with an operating table on the center and various machines around it. To the east is an entryway to a room with an ominous orange glow coming from it.

There is a gigantic hydraulic injection needle next to the table.

Attached to it is a computer.

Lying on the floor is a crumpled piece of paper with the phrase "Lab Notes" written at the top.

>go through door
Which do you mean, the glass door or the revolving door?

>go through glass door
(first opening the glass door)

courtyard
You stand in a beautiful courtyard.

Lying on a bench is a newspaper, with a picture of the lobby on the front page.

* * *

>go north
(first opening the metal door)

operating room
You are in what appears to be an OR, with an operating table on the center and various machines around it. To the east is an entryway to a room with an ominous orange glow coming from it.

There is a gigantic hydraulic injection needle next to the table.

Attached to it is a computer.

Lying on the floor is a crumpled piece of paper with the phrase "Lab Notes" written at the top.

>go west
You can't go that way.

* * *

>go through door
(first opening the revolving door)

lobby
You are standing in the center of the lobby of a modern looking building.  In addition to the revolving door, there is a glass door that appears to lead outside.

In the center of the room is a fountain.

Around the rim of the fountain is a sign in tarnished bronze lettering.

>go through metal door
(first opening the metal door)

operating room
You are in what appears to be an OR, with an operating table on the center and various machines around it. To the east is an entryway to a room with an ominous orange glow coming from it.

There is a gigantic hydraulic injection needle next to the table.

Attached to it is a computer.

Lying on the floor is a crumpled piece of paper with the phrase "Lab Notes" written at the top.

>examine needle
You can't see any such thing.

* * *

>go through metal door
(first opening the metal door)

operating room
You are in what appears to be an OR, with an operating table on the center and various machines around it. To the east is an entryway to a room with an ominous orange glow coming from it.

There is a gigantic hydraulic injection needle next to the table.

Attached to it is a computer.

Lying on the floor is a crumpled piece of paper with the phrase "Lab Notes" written at the top.

>examine  needle
You see nothing special about the needle.

>examine computer
On the screen is green writing on a black background that says "Test subject 0".  Below it is a picture of your face.

>examine lab notes
You can't see any such thing.

>examine notes
It says

"Subject experiences massive memory loss and erratic behavior. Subject's radiation levels far exceed normal limits, yet no damage to the brain can be seen".

* * *

>go through metal door
(first opening the metal door)

operating room
You are in what appears to be an OR, with an operating table on the center and various machines around it. To the east is an entryway to a room with an ominous orange glow coming from it.

There is a gigantic hydraulic injection needle next to the table.

Attached to it is a computer.

Lying on the floor is a crumpled piece of paper with the phrase "Lab Notes" written at the top.

>go through incinerator
You can't see any such thing.

* * *

>go west
street
Blinking in the bright sun you find yourself standing in the middle of a busy street.  People hurry by each other without making eye contact.  To the south is the sidewalk at the other side of the street.  Directly in front of you is an ornate revolving door.

Next to the door is a man leaning against the wall wearing a tuxedo.  He is tall and lean, and is smoking a cigarette.

>go south
far sidewalk
You stand across the street from the building on a nondescript sidewalk.

Nearby is a stranger sitting on the steps of a brick building.

>examine man
You notice that he is wearing a gold watch, and it reminds you that your own watch is missing from you wrist.  Maybe this man could tell you the time.

>ask man about time
He replies "it is 4:25pm on December 29, 2015.

* * *

>go south
far sidewalk
You stand across the street from the building on a nondescript sidewalk.

Nearby is a stranger sitting on the steps of a brick building.

>ask stranger about the time
He replies "it is 4:25pm on December 29, 2015.

* * *

>go west
street
Blinking in the bright sun you find yourself standing in the middle of a busy street.  People hurry by each other without making eye contact.  To the south is the sidewalk at the other side of the street.  Directly in front of you is an ornate revolving door.

Next to the door is a man leaning against the wall wearing a tuxedo.  He is tall and lean, and is smoking a cigarette.

>go north
(first opening the revolving door)

lobby
You are standing in the center of the lobby of a modern looking building.  In addition to the revolving door, there is a glass door that appears to lead outside.

In the center of the room is a fountain.

Around the rim of the fountain is a sign in tarnished bronze lettering.

>go north
(first opening the metal door)

operating room
You are in what appears to be an OR, with an operating table on the center and various machines around it. To the east is an entryway to a room with an ominous orange glow coming from it.

There is a gigantic hydraulic injection needle next to the table.

Attached to it is a computer.

Lying on the floor is a crumpled piece of paper with the phrase "Lab Notes" written at the top.

* * *

>go west
You can't go that way.

>go east
You can't go that way.

* * *

>go north
(first opening the metal door)

operating room
You are in what appears to be an OR, with an operating table on the center and various machines around it. To the east is an entryway to a room with an ominous orange glow coming from it.

There is a gigantic hydraulic injection needle next to the table.

Attached to it is a computer.

Lying on the floor is a crumpled piece of paper with the phrase "Lab Notes" written at the top.

>go east
furnace room
In one wall of the room is a gigantic incinerator, big enough for a truck to pass through.

Standing next to the incinerator is a woman wearing a HAZMAT suit.

>enter incinerator
You sacrificed yourself to save humankind, proving that perhaps you weren't the monster that you thought....

    *** You have won ***

In that game you scored 0 out of a possible 0, in 7 turns.

Would you like to RESTART, RESTORE a saved game, QUIT or UNDO the last command?

* * *

>go east
furnace room
In one wall of the room is a gigantic incinerator, big enough for a truck to pass through.

Standing next to the incinerator is a woman wearing a HAZMAT suit.

>go through incinerator
(first opening the incinerator)

heaven
You can see the incinerator here.

* * *

>ask woman about me
The woman turns around and her eyes go wide when she sees you.  In a solemn voice she says "So you are back.  I didn't know how long you would be gone this time.  Each time you are gone for longer, and you infect more people.  This time was almost three months.  In the year since you were injected with the learning chip you have infected nearly 3 million people, but every time you return back here you can't remember it.  There is no way to stop you.  Unless...."  She slowly looks towards the incinerator.

>go west
operating room
You are in what appears to be an OR, with an operating table on the center and various machines around it. To the east is an entryway to a room with an ominous orange glow coming from it.

There is a gigantic hydraulic injection needle next to the table.

Attached to it is a computer.

Lying on the floor is a crumpled piece of paper with the phrase "Lab Notes" written at the top.

>examine notes
It says

"Subject experiences massive memory loss and erratic behavior. Subject's radiation levels far exceed normal limits, yet no damage to the brain can be seen".

* * *

>go east
furnace room
In one wall of the room is a gigantic incinerator, big enough for a truck to pass through.

Standing next to the incinerator is a woman wearing a HAZMAT suit.

>go east
(first opening the incinerator)

heaven
You stand among the clouds in front of a massive golden gate.

You can see the gate here.

>go through gate
(first opening the gate)
You can't, since the gate leads nowhere.

* * *

>go north
(first opening the metal door)

operating room
You are in what appears to be an OR, with an operating table on the center and various machines around it. To the east is an entryway to a room with an ominous orange glow coming from it.

There is a gigantic hydraulic injection needle next to the table.

Attached to it is a computer.

Lying on the floor is a crumpled piece of paper with the phrase "Lab Notes" written at the top.

>go east
You can't go that way.

* * *

>go west
street
Blinking in the bright sun you find yourself standing in the middle of a busy street.  People hurry by each other without making eye contact.  To the south is the sidewalk at the other side of the street.  Directly in front of you is an ornate revolving door.

Next to the door is a man leaning against the wall wearing a tuxedo.  He is tall and lean, and is smoking a cigarette.

>go norh
You can't see any such thing.

>go north
(first opening the revolving door)

lobby
You are standing in the center of the lobby of a modern looking building.  In addition to the revolving door, there is a glass door that appears to lead outside.

In the center of the room is a fountain.

Around the rim of the fountain is a sign in tarnished bronze lettering.

* * *

>go north
(first opening the metal door)

operating room
You are in what appears to be an OR, with an operating table on the center and various machines around it. To the east is an entryway to a room with an ominous orange glow coming from it.

There is a gigantic hydraulic injection needle next to the table.

Attached to it is a computer.

Lying on the floor is a crumpled piece of paper with the phrase "Lab Notes" written at the top.

>go east
furnace room
In one wall of the room is a gigantic incinerator, big enough for a 

You can see the incinerator here.

>enter incinerator
you dead

* * *

>examine woman
She looks to be a scientist.  Maybe she knows you.

>ask woman about butts
boobe

* * *

>go west
street
Blinking in the bright sun you find yourself standing in the middle of a busy street.  People hurry by each other without making eye contact.  To the south is the sidewalk at the other side of the street.  Directly in front of you is an ornate revolving door.

Next to the door is a man leaning against the wall wearing a tuxedo.  He is tall and lean, and is smoking a cigarette.

>go norht
You can't see any such thing.

>go north
(first opening the revolving door)

lobby
You are standing in the center of the lobby of a modern looking building.  In addition to the revolving door, there is a glass door that appears to lead outside.

In the center of the room is a fountain.

Around the rim of the fountain is a sign in tarnished bronze lettering.

>go east
You can't go that way.

>go north
(first opening the metal door)

operating room
You are in what appears to be an OR, with an operating table on the center and various machines around it. To the east is an entryway to a room with an ominous orange glow coming from it.

There is a gigantic hydraulic injection needle next to the table.

Attached to it is a computer.

Lying on the floor is a crumpled piece of paper with the phrase "Lab Notes" written at the top.

* * *

>go east
furnace room
In one wall of the room is a gigantic incinerator, big enough for a truck to pass through.

Standing next to the incinerator is a woman wearing a HAZMAT suit.

>go east
(first opening the incinerator)

heaven
You stand among the clouds in front of a massive golden gate.

>go through gate
(first opening the gate)
You sacrificed yourself to save humankind, proving that perhaps you weren't the monster that you thought....

    *** You have won ***

In that game you scored 0 out of a possible 0, in 9 turns.

Would you like to RESTART, RESTORE a saved game, QUIT or UNDO the last command?

* * *

>go down
alley
After an arduous descent down the rusting stairs, you find yourself in a dimly lit alley.  To the west you can see the street.  East the alley appears to go deeper, and gets darker as it goes.

Nearby you lurks a mangy looking alley cat.  Perhaps it is safe to take with you as a companion.

>goo west
That's not a verb I recognise.

>go west
street
Blinking in the bright sun you find yourself standing in the middle of a busy street.  People hurry by each other without making eye contact.  Directly in front of you is an ornate revolving door.

Next to the door is a man leaning against the wall wearing a tuxedo.  He is tall and lean, and is smoking a cigarette.

>go through door
(first opening the revolving door)

lobby
You are standing in the center of the lobby of a modern looking building.  In addition to the revolving door, there is a glass door that appears to lead outside.

In the center of the room is a fountain.

Around the rim of the fountain is a sign in tarnished bronze lettering.

>go outside
You can't go that way.

>go through glass door
(first opening the glass door)

courtyard
You stand in a beautiful courtyard.

Lying on a bench is a newspaper, with a picture of the lobby on the front page.

>go through door
lobby
You are standing in the center of the lobby of a modern looking building.  In addition to the revolving door, there is a glass door that appears to lead outside.

In the center of the room is a fountain.

Around the rim of the fountain is a sign in tarnished bronze lettering.

* * *

>go down
fire escape
You hang from the edge of the building and drop down 10 feet onto the fire escape, landing precariously and barely keeping your balance above a dizzying drop.   A rickety set of metal stairs leads down to the ground.

Lying next to your foot is a bottle with a single pill in it.

>examine bottle
In bright letters it says "Radiation Medication."   There appears to be some fine print below it.

>eat medication
(first taking the bottle)
Your head starts to spin and you fall to your knees, vomiting uncontrollably through the grate of the fire escape for several minutes.

* * *

>go down
fire escape
You hang from the edge of the building and drop down 10 feet onto the fire escape, landing precariously and barely keeping your balance above a dizzying drop.   A rickety set of metal stairs leads down to the ground.

Lying next to your foot is a bottle with a single pill in it.

>take bottle
Taken.

>examine it
In bright letters it says "Radiation Medication."  There appears to be some fine print below it.

>examine it
The fine print states that Radiation poisoning is a serious condition  but that if the medication is used on a non-human subject there can be harmful side effects.

>eat it
Your head starts to spin and you fall to your knees, vomiting uncontrollably through the grate of the fire escape for several minutes.

* * *

>take bottle
Taken.

>eat it
Your head starts to spin and you fall to your knees, vomiting uncontrollably through the grate of the fire escape for several minutes.

* * *

>go down
fire escape
You hang from the edge of the building and drop down 10 feet onto the fire escape, landing precariously and barely keeping your balance above a dizzying drop.   A rickety set of metal stairs leads down to the ground.

Lying next to your foot is a bottle with a single pill in it.

>examine rope
It appears to be relatively new, and might be long enough to reach the ground.

>go down
You jump down to the fire escape but it was much farther than you anticipated, and your legs both break on impact.  Your vision darkens and you fall unconscious

* * *

>go down
fire escape
You hang from the edge of the building and drop down 10 feet onto the fire escape, landing precariously and barely keeping your balance above a dizzying drop.   A rickety set of metal stairs leads down to the ground.

Lying next to your foot is a bottle with a single pill in it.

>take rope
Taken.

>go down
You jump down to the fire escape but it was much farther than you anticipated, and your legs both break on impact.  Your vision darkens and you fall unconscious.

>examine rope
It appears to be relatively new, and might be long enough to reach the ground.

>go down
You jump down to the fire escape but it was much farther than you anticipated, and your legs both break on impact.  Your vision darkens and you fall unconscious.

* * *

>go down
fire escape
You hang from the edge of the building and drop down 10 feet onto the fire escape, landing precariously and barely keeping your balance above a dizzying drop.   A rickety set of metal stairs leads down to the ground.

Lying next to your foot is a bottle with a single pill in it.

>take pill
Taken.

>examine pill
In bright letters it says "Radiation Medication."  There appears to be some fine print below it.

>eat pill
Your head starts to spin and you fall to your knees, vomiting uncontrollably through the grate of the fire escape for several minutes.

>go down
alley
After an arduous descent down the rusting stairs, you find yourself in a dimly lit alley.

Nearby you lurks a mangy looking alley cat.

>say hi to cat
There is no reply.

>say hi
(to the cat)
There is no reply.

>take it
You must name something more substantial.

>take all
(the cat)
The rabid beast leaps onto your face and claws you until you collapse into an unconscious heap to be devoured

>take cat
The rabid beast leaps onto your face and claws you until you collapse into an unconscious heap to be devoured

>examine cat
It is clearly very diseased.

>go
You'll have to say which compass direction to go in.

I beg your pardon?

I beg your pardon?

>go up
fire escape
You hang from the edge of the building and drop down 10 feet onto the fire escape, landing precariously and barely keeping your balance above a dizzying drop.   A rickety set of metal stairs leads down to the ground.

>go up
roof
You wake up lying on your back on the roof of a building.  There are no visible doors but there is a fire escape down from you.

You stand up, dizzy, trying to remember any events that might have transpired leaving you in this dire predicament.  Nothing comes to mind.

A crumpled scrap of paper lies on the ground.

* * *

>go down
fire escape
You hang from the edge of the building and drop down 10 feet onto the fire escape, landing precariously and barely keeping your balance above a dizzying drop.   A rickety set of metal stairs leads down to the ground.

Lying next to your foot is a bottle with a single pill in it.

>go up
roof
You stand as a solitary figure on the empty rooftop.  The fire escape is below you.

A crumpled scrap of paper lies on the ground.

>go down
fire escape

Lying next to your foot is a bottle with a single pill in it.

* * *

>go up
roof
You stand as a solitary figure on the empty rooftop.  The fire escape is below you.

A crumpled scrap of paper lies on the ground.

>take paper
[Your score has just gone up by ten points.]

>go down
fire escape
You stand somewhat uncomfortably on the fire escape with the rickety stairs below you and the roof a short but frightening climb above you.

Lying next to your foot is a bottle with a single pill in it.

* * *

>take bottle
Taken.

>eat pill
Your head starts to spin and you fall to your knees, vomiting uncontrollably through the grate of the fire escape for several minutes
[Your score has just gone up by ten points.]

>go down
alley
After an arduous descent down the rusting stairs, you find yourself in a dimly lit alley.  To the west you can see the street.  East the alley appears to go deeper, and gets darker as it goes.

Nearby you lurks a mangy looking alley cat.  Perhaps it is safe to take with you as a companion.

* * *

>examine woman
What did your parents tell you about talking to strangers?  Then again... she might know what happened.

>ask her about what happened
The woman's eyes go wide and she says "You mean the epidemic? How could you not know?

>go west
alley
You stand in the dim alley, with the street to the west and the alley extending to the east.

Nearby you lurks a mangy looking alley cat.  Perhaps it is safe to take with you as a companion.

>go west
street
Blinking in the bright sun you find yourself standing in the middle of a busy street.  People hurry by each other without making eye contact.  To the south is the sidewalk at the other side of the street.  Directly in front of you is an ornate revolving door.

Next to the door is a man leaning against the wall wearing a tuxedo.  He is tall and lean, and is smoking a cigarette.

* * *

>ask man about building
He says in an incredulous tone: "What do you mean?!?  That is where we used to work!

[Your score has just gone up by ten points.]

>go south
far sidewalk
You stand across the street from the building on a nondescript sidewalk.

Nearby is a stranger sitting on the steps of a brick building.

>examine stranger
You notice that he is wearing a gold watch, and it reminds you that your own watch is missing from you wrist.  Maybe this man could tell you the time.

>ask stranger about the time
He replies "it is 4:25pm on December 29, 2015".

[Your score has just gone up by ten points.]

>go north
street
Blinking in the bright sun you find yourself standing in the middle of a busy street.  People hurry by each other without making eye contact.  To the south is the sidewalk at the other side of the street.  Directly in front of you is an ornate revolving door.

Next to the door is a man leaning against the wall wearing a tuxedo.  He is tall and lean, and is smoking a cigarette.

>go north
(first opening the revolving door)

lobby
You are standing in the center of the lobby of a modern looking building.  In addition to the revolving door, there is a glass door that appears to lead outside.

In the center of the room is a fountain.

Around the rim of the fountain is a sign in tarnished bronze lettering.

>examine fountain
It is completely dry, and appears to have been that way for some time.

* * *

>examine sign
It reads National Artificial Intelligence Agency

[Your score has just gone up by ten points.]

>go through glass door
(first opening the glass door)

courtyard
You stand in a beautiful courtyard.  The glass door is behind you.

Lying on a bench is a newspaper, with a picture of the lobby on the front page.

>take newspaper
Taken.

>examine it
The date in the top corner is January 1, 2015.  The headline reads "NAIA Shuts Down After Brain Implant Catasrophe.

[Your score has just gone up by ten points.]

>go through glass door
lobby
You are standing in the center of the lobby of a modern looking building.  In addition to the revolving door, there is a glass door that appears to lead outside.

In the center of the room is a fountain.

Around the rim of the fountain is a sign in tarnished bronze lettering.

>go through metal door
(first opening the metal door)

operating room
You are in what appears to be an OR, with an operating table on the center and various machines around it. To the east is an entryway to a room with an ominous orange glow coming from it.

There is a gigantic hydraulic injection needle next to the table.

Attached to it is a computer.

Lying on the floor is a crumpled piece of paper with the phrase "Lab Notes" written at the top.

>take computer
Taken.

>take door
That's hardly portable.

* * *

Amnesia
An Interactive Fiction by Ben Helm
Release 1 / Serial number 140313 / Inform 7 build 6G60 (I6/v6.32 lib 6/12N) SD

roof
You wake up lying on your back on the roof of a building.  There are no visible doors but there is a fire escape down from you.

You stand up, dizzy, trying to remember any events that might have transpired leaving you in this dire predicament.  Nothing comes to mind.

A crumpled scrap of paper lies on the ground.

>go dow
You can't see any such thing.

>go down
street
After an arduous descent down hundreds of feet of solid granite, you find yourself at the side of an empty street.  Directly in front of you is an ornate revolving door; an entrance to the building.

>examine door
The lock seems to have been forcibly broken, and the door swings freely.

* * *

Amnesia
An Interactive Fiction by Ben Helm
Release 1 / Serial number 140313 / Inform 7 build 6G60 (I6/v6.32 lib 6/12N) SD

roof
You wake up lying on your back on the roof of a building.  There are no visible doors but there is a fire escape down from you.

You stand up, dizzy, trying to remember any events that might have transpired leaving you in this dire predicament.  Nothing comes to mind.

A crumpled scrap of paper lies on the ground.

>take rope
Taken.

>go down
alley
After an arduous descent down hundreds of feet of solid granite, you find yourself in a dim lit alley.

* * *

Amnesia
An Interactive Fiction by Ben Helm
Release 1 / Serial number 140313 / Inform 7 build 6G60 (I6/v6.32 lib 6/12N) SD

roof
You wake up lying on your back on the roof of a building.  There are no visible doors but there is a fire escape down from you.

You stand up, dizzy, trying to remember any events that might have transpired leaving you in this dire predicament.  Nothing comes to mind.

A crumpled scrap of paper lies on the ground.

>examine paper
On the paper is scrawled in red script are the words  not again 

[Your score has just gone up by ten points.]

>take rope
Taken.

>examine it
It appears to be relatively new, and might be long enough to reach the ground.

>go down
fire escape
After a daring rappel down 100 feet of faceless granite, you reach the fire escape.  A rickety set of metal stairs leads down to the ground.

Lying next to your foot is a bottle with a single pill in it.

>examine bottle
In bright letters it says "Radiation Medication."  There appears to be some fine print below it.

>examine it
The fine print states that Radiation poisoning is a serious condition and that any human will die quickly without medication, but that if the medication is used on a non-human subject there can be harmful side effects.

>eat it
(first taking the bottle)
Your head starts to spin and you fall to your knees, vomiting uncontrollably through the grate of the fire escape for several minutes.

>go down
alley
After an arduous descent down the rusting stairs, you find yourself in a dimly lit alley.

* * *

>examine paper
On the paper is scrawled in red script are the words  not again 

[Your score has just gone up by ten points.]

>go down
fire escape
You hang from the edge of the building and drop down 10 feet onto the fire escape, landing precariously and barely keeping your balance above a dizzying drop.   A rickety set of metal stairs leads down to the ground.

Lying next to your foot is a bottle with a single pill in it.

>examine pill
In bright letters it says "Radiation Medication."  There appears to be some fine print below it.

>take pill
Taken.

>eat pill
Your head starts to spin and you fall to your knees, vomiting uncontrollably through the grate of the fire escape for several minutes
[Your score has just gone up by ten points.]

* * *

>go east
deep alley
It is darker here.  Your eyes adjust slowly.

You can see the outline of a woman standing nearby.

>ask woman about what happened
The woman's eyes go wide and she says "You mean the epidemic? How could you not know?

* * *

>go down
fire escape
You hang from the edge of the building and drop down 10 feet onto the fire escape, landing precariously and barely keeping your balance above a dizzying drop.   A rickety set of metal stairs leads down to the ground.

Lying next to your foot is a bottle with a single pill in it.

>eat pill
(first taking the bottle)
Your head starts to spin and you fall to your knees, vomiting uncontrollably through the grate of the fire escape for several minutes
[Your score has just gone up by ten points.]

>go down
alley
After an arduous descent down the rusting stairs, you find yourself in a dimly lit alley.  To the west you can see the street.  East the alley appears to go deeper, and gets darker as it goes.

Nearby you lurks a mangy looking alley cat.  Perhaps it is safe to take with you as a companion.

* * *

>go east
deep alley
It is darker here.  Your eyes adjust slowly.

You can see the outline of a woman standing nearby.

>ask woman about what happened
The woman's eyes go wide and she says "You mean the epidemic? How could you not know?

[Your score has just gone up by ten points.]

>go west
alley
You stand in the dim alley, with the street to the west and the alley extending to the east.

Nearby you lurks a mangy looking alley cat.  Perhaps it is safe to take with you as a companion.

* * *

>go west
street
Blinking in the bright sun you find yourself standing in the middle of a busy street.  People hurry by each other without making eye contact.  To the south is the sidewalk at the other side of the street.  Directly in front of you is an ornate revolving door.

Next to the door is a man leaning against the wall wearing a tuxedo.  He is tall and lean, and is smoking a cigarette.

>ask man about building
He says in an incredulous tone: "What do you mean?!?  That is where we used to work!

[Your score has just gone up by ten points.]

>go south
far sidewalk
You stand on the south side of the street on a nondescript sidewalk.  The building is on the north side.

Nearby is a stranger sitting on the steps of a brick building.

>ask stranger about the time
He replies "it is 4:25pm on December 29, 2015".

[Your score has just gone up by ten points.]

* * *

>go north
street
Blinking in the bright sun you find yourself standing in the middle of a busy street.  People hurry by each other without making eye contact.  To the south is the sidewalk at the other side of the street.  Directly in front of you is an ornate revolving door.

Next to the door is a man leaning against the wall wearing a tuxedo.  He is tall and lean, and is smoking a cigarette.

>go north
(first opening the revolving door)

lobby
You are standing in the center of the lobby of a modern looking building.  In addition to the revolving door, there is a glass door that appears to lead outside to the west and a metal door to the north.  In the center of the room is a fountain, and around the rim is a sign in tarnished bronze lettering.

>examine fountain
It is completely dry, and appears to have been that way for some time.

* * *

>examine sign
It reads National Artificial Intelligence Agency

[Your score has just gone up by ten points.]

>go west
(first opening the glass door)

courtyard
You stand in a beautiful courtyard.  The glass door is behind you.

Lying on a bench is a newspaper, with a picture of the lobby on the front page.

>examine newspaper
The date in the top corner is January 1, 2015.  The headline reads "NAIA Shuts Down After Brain Implant Catasrophe.

[Your score has just gone up by ten points.]

>go east
lobby
You are standing in the center of the lobby of a modern looking building.  In addition to the revolving door, there is a glass door that appears to lead outside to the west and a metal door to the north.  In the center of the room is a fountain, and around the rim is a sign in tarnished bronze lettering.

>go north
(first opening the metal door)

operating room
You are in what appears to be an OR, with an operating table on the center and various machines around it. To the east is an entryway to a room with an ominous orange glow coming from it.  There is a gigantic hydraulic injection needle next to the table, with a computer attached to it.

Lying on the floor is a crumpled piece of paper with the phrase "Lab Notes" written at the top.

>examine lab notes
It says

"Subject experiences massive memory loss and erratic behavior.  Subject's radiation levels far exceed normal limits, and will cause severe radiation poisoning to anyone in the vicinity.  Subject seems to be immune to the radiation.

[Your score has just gone up by ten points.]

>examine computer
On the screen is green writing on a black background that says "Test subject 0".  Below it is a picture of your face.

[Your score has just gone up by ten points.]

>go east
furnace room
In one wall of the room is a gigantic incinerator, big enough for a truck to pass through.

Standing next to the incinerator is a woman wearing a HAZMAT suit.

* * *

>go through incinerator
(first opening the incinerator)

heaven
You stand among the clouds in front of a massive golden gate.

>go through gate
(first opening the gate)
You sacrificed yourself to save humankind, proving that perhaps you weren't the monster that you thought....

    *** You have won ***

In that game you scored 90 out of a possible 100, in 26 turns.

Would you like to RESTART, RESTORE a saved game, QUIT or UNDO the last command?

* * *

>examine woman
What did your parents tell you about talking to strangers?  Then again... she might know what happened.

>ask woman about what happened
The woman's eyes go wide and she says "You mean the overtaking? How could you not know?