You wake up lying on your back on the roof of a skyscraper.  There are no visible doors or way down
game
An Interactive Fiction by benji
Release 1 / Serial number 140305 / Inform 7 build 6G60 (I6/v6.32 lib 6/12N) SD

roof
You stand up, dizzy, trying to remember any events that might have transpired leaving you in this dire predicament.  Nothing comes to mind.

A crumpled scrap of paper lies on the ground.

Next to it is a tiny white bottle.

There is another bottle lying nearby as well, identical except that it is black.

>go north
You can't go that way.

>eat my butt
I only understood you as far as wanting to eat yourself.

>eat your butt
You can't see any such thing.

>slap my face
That's not a verb I recognise.

>take my face
You can't see any such thing.

>swing my face
You can't see any such thing.

>at your face
That's not a verb I recognise.

>kill myself
Violence isn't the answer to this one.

>kill yourself
Violence isn't the answer to this one.

>kill the dog
You can't see any such thing.

>eat the dog
You can't see any such thing.

>eat my mouth
I only understood you as far as wanting to eat yourself.

>eat my
(yourself)
(first taking yourself)
You are always self-possessed.

>say butt
(to yourself)
There is no reply.

>say fatty fat fatty
(to yourself)
There is no reply.

>yell
That's not a verb I recognise.

>jump
You jump on the spot, fruitlessly.

>jump down
I only understood you as far as wanting to jump.

>jump on my face
I only understood you as far as wanting to jump.

* * *

You wake up lying on your back on the roof of a skyscraper.  There are no visible doors or way down
game
An Interactive Fiction by benji
Release 1 / Serial number 140305 / Inform 7 build 6G60 (I6/v6.32 lib 6/12N) SD

roof
You stand up, dizzy, trying to remember any events that might have transpired leaving you in this dire predicament.  Nothing comes to mind.

A crumpled scrap of paper lies on the ground.

Next to it is a tiny white bottle.

There is another bottle lying nearby as well, identical except that it is black.

>take coin
Taken.

>examine coin
You see nothing special about the Rusty Coin.

>drop coin
Dropped.

>take coin
Taken.

>examine it
You see nothing special about the Rusty Coin.

>drop it
Dropped.

>take it
Taken.

>drop it
Dropped.

>examine it
You see nothing special about the Rusty Coin.

* * *

>take coin
Taken.

>drop coin
Dropped.

>pee on it
That's not a verb I recognise.

>pee on my head
That's not a verb I recognise.

>take my face
You can't see any such thing.

>take my butt
You can't see any such thing.

>eat my face
You can't see any such thing.

>eat my butt
You can't see any such thing.

>drop your pants
You can't see any such thing.

* * *

You wake up lying on your back on the roof of a skyscraper.  There are no visible doors or way down
game
An Interactive Fiction by benji
Release 1 / Serial number 140305 / Inform 7 build 6G60 (I6/v6.32 lib 6/12N) SD

roof
You stand up, dizzy, trying to remember any events that might have transpired leaving you in this dire predicament.  Nothing comes to mind.

A crumpled scrap of paper lies on the ground.

Next to it is a tiny white bottle.

There is another bottle lying nearby as well, identical except that it is black.

>take scrap
Taken.

>drop it
Dropped.

>take paper
Taken.

>drop it
Dropped.

>take of
Taken.

>drop it
Dropped.

>examine it
On the paper is scrawled in red script the word  BUTTSACK .

* * *

You wake up lying on your back on the roof of a skyscraper.  There are no visible doors or way down
game
An Interactive Fiction by benji
Release 1 / Serial number 140305 / Inform 7 build 6G60 (I6/v6.32 lib 6/12N) SD

roof
You stand up, dizzy, trying to remember any events that might have transpired leaving you in this dire predicament.  Nothing comes to mind.

A crumpled scrap of paper lies on the ground.

Next to it is a tiny white bottle.

There is another bottle lying nearby as well, identical except that it is black.

>take bottle
Which do you mean, the white bottle or the black bottle?

>take white bottle
Taken.

>drop it
Dropped.

>take white
Taken.

>drop it
Dropped.

>examine white
Inside the bottle is a liquid that appears to be water.

>drink liquid
You can't see any such thing.